000000000000010000
000001000001000110
000001000001010010
000111000001010111
000100000001000010
000111110001111011
000000000000010001
000000000001000100